111111111111111
111111111111111
111111111111111
111111111111111
111222222222111
111211131112111
111211131112111
111211131112111
111222222222111
111111111111111
111111111111111
111111111111111
111111111111111
111111111111111
111111111111111